Welsh	cy.xml
German	de.xml
Greek	el.xml
English	english.xml
Spanish	es.xml
Finnish	fi.xml
French	fr.xml
Hindi	hi.xml
Italian	it.xml
Japanese	ja.xml
Dutch	nl.xml
Polish	pl.xml
Portugese	pt.xml
Russian	ru.xml
Swedish	sv.xml
Turkish	tr.xml
Urdu	ur.xml
Chinese (Traditional)	zh-CHT.xml
Arabic	ar.xml
Estonian	et.xml
Hungarian	hu.xml
Croatian	hr.xml
Indonesian	id.xml
Vietnamese	vi.xml
Persian	fa.xml
Norwegian	no.xml
Thai	th.xml
Hebrew	he.xml
Catalan	ca.xml
Czech	cs.xml
Danish	da.xml
Bangla	bn.xml
Bulgarian	bg.xml